2021-02-28_09:24:58,Ahmadabad,34,0,437129,401107,838236,0,0,0,0.00,District Panchayat
2021-02-28_09:24:58,Amreli,34,2,487298,451365,938663,2945,771,3716,0.40,District Panchayat
2021-02-28_09:24:58,Anand,42,0,628846,586893,1215739,0,0,0,0.00,District Panchayat
2021-02-28_09:24:58,Arvalli,30,0,376844,359118,735962,0,0,0,0.00,District Panchayat
2021-02-28_09:24:58,Bharuch,34,2,468837,435571,904408,364,192,556,0.06,District Panchayat
2021-02-28_09:24:58,Bhavnagar,40,10,603309,554664,1157973,16361,8731,25092,2.17,District Panchayat
2021-02-28_09:24:58,Botad,20,0,132592,117981,250573,0,0,0,0.00,District Panchayat
2021-02-28_09:24:58,ChhotaUdaipur,32,0,392553,369603,762156,0,0,0,0.00,District Panchayat
2021-02-28_09:24:58,DevbhumiDwarka,22,2,207700,192898,400598,1273,490,1763,0.44,District Panchayat
2021-02-28_09:24:58,Dohad,50,1,670243,671292,1341535,1041,584,1625,0.12,District Panchayat
2021-02-28_09:24:58,Gandhinagar,28,6,366066,346877,712943,8502,4987,13489,1.89,District Panchayat
2021-02-28_09:24:58,GirSomnath,28,3,360516,339611,700127,4780,2296,7076,1.01,District Panchayat
2021-02-28_09:24:58,Jamnagar,24,2,281592,261459,543051,3647,1468,5115,0.94,District Panchayat
2021-02-28_09:24:58,Junagadh,30,2,404115,370824,774939,4566,1901,6467,0.83,District Panchayat
2021-02-28_09:24:58,Kachchh,40,0,557441,517942,1075383,0,0,0,0.00,District Panchayat
2021-02-28_09:24:58,Mahesana,42,0,673866,623203,1297069,0,0,0,0.00,District Panchayat
2021-02-28_09:24:58,Mahisagar,28,3,348235,328536,676771,3250,1801,5051,0.75,District Panchayat
2021-02-28_09:24:58,Morbi,24,19,281342,260224,541566,30545,10972,41517,7.67,District Panchayat
2021-02-28_09:24:58,Narmada,22,0,210704,204208,414912,0,0,0,0.00,District Panchayat
2021-02-28_09:24:58,Navsari,30,12,387723,389351,777074,15274,8961,24235,3.12,District Panchayat
2021-02-28_09:24:58,PanchMahals,38,0,460474,433704,894178,0,0,0,0.00,District Panchayat
2021-02-28_09:24:58,Patan,32,4,461883,424727,886610,6464,2549,9013,1.02,District Panchayat
2021-02-28_09:24:58,Porbandar,18,4,124573,115251,239824,2318,1026,3344,1.39,District Panchayat
2021-02-28_09:24:58,Rajkot,36,0,503482,456937,960419,0,0,0,0.00,District Panchayat
2021-02-28_09:24:58,SabarKantha,36,8,469961,442942,912903,10276,5118,15394,1.69,District Panchayat
2021-02-28_09:24:58,Surat,36,0,496818,484416,981234,0,0,0,0.00,District Panchayat
2021-02-28_09:24:58,Surendranagar,34,0,426424,381862,808286,0,0,0,0.00,District Panchayat
2021-02-28_09:24:58,Tapi,26,0,286594,298827,585421,0,0,0,0.00,District Panchayat
2021-02-28_09:24:58,TheDangs,18,0,82544,81642,164186,0,0,0,0.00,District Panchayat
2021-02-28_09:24:58,Vadodara,34,3,496440,465390,961830,3415,1520,4935,0.51,District Panchayat
2021-02-28_09:24:58,Valsad,38,1,484869,466807,951676,962,458,1420,0.15,District Panchayat
2021-02-28_09:24:58,Ahmadabad,176,0,454975,418323,873298,0,0,0,0,Taluka Panchayat
2021-02-28_09:24:58,Amreli,192,23,487298,451365,938663,4968,1513,6481,0.69,Taluka Panchayat
2021-02-28_09:24:58,Anand,196,44,626520,584808,1211328,13691,5567,19258,1.59,Taluka Panchayat
2021-02-28_09:24:58,Arvalli,128,30,368154,350994,719148,8445,4066,12511,1.74,Taluka Panchayat
2021-02-28_09:24:58,Bharuch,182,3,480358,446990,927348,485,229,714,0.08,Taluka Panchayat
2021-02-28_09:24:58,Bhavnagar,210,87,590740,543431,1134171,22534,10487,33021,2.91,Taluka Panchayat
2021-02-28_09:24:58,Botad,78,0,191721,173802,365523,0,0,0,0,Taluka Panchayat
2021-02-28_09:24:58,ChhotaUdaipur,140,0,392553,369603,762156,0,0,0,0,Taluka Panchayat
2021-02-28_09:24:58,DevbhumiDwarka,80,25,207103,192161,399264,5779,2052,7831,1.96,Taluka Panchayat
2021-02-28_09:24:58,Dohad,238,12,656863,657838,1314701,2901,1884,4785,0.36,Taluka Panchayat
2021-02-28_09:24:58,Gandhinagar,80,1,270453,255137,525590,289,146,435,0.08,Taluka Panchayat
2021-02-28_09:24:58,GirSomnath,128,33,360516,339611,700127,9909,4638,14547,2.08,Taluka Panchayat
2021-02-28_09:24:58,Jamnagar,112,18,279529,259594,539123,4079,1621,5700,1.06,Taluka Panchayat
2021-02-28_09:24:58,Junagadh,158,20,410567,376351,786918,6296,2398,8694,1.10,Taluka Panchayat
2021-02-28_09:24:58,Kachchh,204,19,545962,507021,1052983,5386,2148,7534,0.72,Taluka Panchayat
2021-02-28_09:24:58,Kheda,166,27,479824,449787,929611,8099,2410,10509,1.13,Taluka Panchayat
2021-02-28_09:24:58,Mahesana,216,25,659374,609297,1268671,8679,4219,12898,1.02,Taluka Panchayat
2021-02-28_09:24:58,Mahisagar,126,49,348235,328536,676771,9366,3444,12810,1.89,Taluka Panchayat
2021-02-28_09:24:58,Morbi,102,55,279274,258232,537506,21767,8102,29869,5.56,Taluka Panchayat
2021-02-28_09:24:58,Narmada,90,5,210704,204208,414912,1179,877,2056,0.50,Taluka Panchayat
2021-02-28_09:24:58,Navsari,132,39,387723,389351,777074,13286,7955,21241,2.73,Taluka Panchayat
2021-02-28_09:24:58,PanchMahals,178,0,466180,438821,905001,0,0,0,0,Taluka Panchayat
2021-02-28_09:24:58,Patan,170,30,449570,413348,862918,8279,3806,12085,1.40,Taluka Panchayat
2021-02-28_09:24:58,Porbandar,54,16,124573,115251,239824,2318,1026,3344,1.39,Taluka Panchayat
2021-02-28_09:24:58,Rajkot,202,46,492428,446988,939416,11616,4084,15700,1.67,Taluka Panchayat
2021-02-28_09:24:58,SabarKantha,172,40,469961,442942,912903,10276,5118,15394,1.69,Taluka Panchayat
2021-02-28_09:24:58,Surat,184,16,475930,463811,939741,3733,1849,5582,0.59,Taluka Panchayat
2021-02-28_09:24:58,Surendranagar,182,1,416756,373082,789838,319,125,444,0.06,Taluka Panchayat
2021-02-28_09:24:58,Tapi,124,4,280467,292686,573153,582,513,1095,0.19,Taluka Panchayat
2021-02-28_09:24:58,TheDangs,48,0,89013,88272,177285,0,0,0,0,Taluka Panchayat
2021-02-28_09:24:58,Vadodara,168,15,496439,465391,961830,2492,971,3463,0.36,Taluka Panchayat
2021-02-28_09:24:58,Valsad,158,20,483232,465029,948261,5077,3430,8507,0.90,Taluka Panchayat
2021-02-28_09:24:58,Ahmadabad,24,6,68270,65462,133732,831,555,1386,1.04,Nagarpalika
2021-02-28_09:24:58,Amreli,39,12,110302,102978,213280,1413,724,2137,1.00,Nagarpalika
2021-02-28_09:24:58,Anand,53,18,199229,192972,392201,5486,3190,8676,2.21,Nagarpalika
2021-02-28_09:24:58,Arvalli,15,8,34878,34489,69367,1312,946,2258,3.26,Nagarpalika
2021-02-28_09:24:58,BanasKantha,28,17,116630,107564,224194,4949,2972,7921,3.53,Nagarpalika
2021-02-28_09:24:58,Bharuch,33,13,134465,130222,264687,2217,2000,4217,1.59,Nagarpalika
2021-02-28_09:24:58,Bhavnagar,24,24,67987,64177,132164,5391,3126,8517,6.44,Nagarpalika
2021-02-28_09:24:58,Botad,17,17,62086,58158,120244,4748,2449,7197,5.99,Nagarpalika
2021-02-28_09:24:58,DevbhumiDwarka,13,5,24848,23388,48236,1025,545,1570,3.25,Nagarpalika
2021-02-28_09:24:58,Dohad,9,0,43099,42797,85896,0,0,0,0,Nagarpalika
2021-02-28_09:24:58,Gandhinagar,18,13,67142,63821,130963,4648,2944,7592,5.80,Nagarpalika
2021-02-28_09:24:58,GirSomnath,32,17,102302,98670,200972,2557,1374,3931,1.96,Nagarpalika
2021-02-28_09:24:58,Jamnagar,7,3,10501,9981,20482,408,291,699,3.41,Nagarpalika
2021-02-28_09:24:58,Junagadh,9,0,31920,29712,61632,0,0,0,0,Nagarpalika
2021-02-28_09:24:58,Kachchh,49,14,223899,205551,429450,4149,2157,6306,1.47,Nagarpalika
2021-02-28_09:24:58,Kheda,38,0,139308,136416,275724,0,0,0,0,Nagarpalika
2021-02-28_09:24:58,Mahesana,38,13,146205,137568,283773,2996,2371,5367,1.89,Nagarpalika
2021-02-28_09:24:58,Morbi,26,20,99200,91592,190792,8725,3804,12529,6.57,Nagarpalika
2021-02-28_09:24:58,Narmada,7,1,14435,14979,29414,298,175,473,1.61,Nagarpalika
2021-02-28_09:24:58,Navsari,19,6,122774,114496,237270,776,451,1227,0.52,Nagarpalika
2021-02-28_09:24:58,PanchMahals,17,6,65658,63394,129052,1093,751,1844,1.43,Nagarpalika
2021-02-28_09:24:58,Patan,20,9,87861,82086,169947,1931,1254,3185,1.87,Nagarpalika
2021-02-28_09:24:58,Porbandar,13,13,94793,90435,185228,4943,2599,7542,4.07,Nagarpalika
2021-02-28_09:24:58,Rajkot,11,11,46389,43265,89654,2544,1504,4048,4.52,Nagarpalika
2021-02-28_09:24:58,SabarKantha,15,14,39922,38700,78622,3334,1987,5321,6.77,Nagarpalika
2021-02-28_09:24:58,Surat,29,16,54734,48680,103414,3276,1983,5259,5.09,Nagarpalika
2021-02-28_09:24:58,Surendranagar,41,6,162569,151850,314419,969,539,1508,0.48,Nagarpalika
2021-02-28_09:24:58,Tapi,7,0,16206,16471,32677,0,0,0,0,Nagarpalika
2021-02-28_09:24:58,Vadodara,22,21,45406,44084,89490,4166,3016,7182,8.03,Nagarpalika
2021-02-28_09:24:58,Valsad,7,0,12159,9820,21979,0,0,0,0,Nagarpalika
